111111111111111
110C10000000C11
1100001000C0011
11P0C01E0000011
111111111111111
111011010000111
111011011110111
111000010000111
111111010111111
111111010000111
111111111111111