1111111111111
1P0000C000E11
1111111111111