1111111111111
10010000000C1
1000011111001
1P011E0C000P1
1111111111111