1111111111111
10010000000C1
10000111001
1P0011E0C0001
1111111111111