1111111111111
11100000000C1
1100011111011
1000000000001
10P011ECC0001
1000000000001
1111111111111