1111111111111
111100C0000C1
1100011111001
100C0C1000001
10P011E0C0101
1000000000001
1111111111111
